# Europe #
LIZ	= "countries/Great Exardia.txt"
IMM	= "countries/Immerheim.txt"
RAO	= "countries/Romance Empire.txt"
ATL	= "countries/Atlantis.txt"
KFP	= "countries/Kiara.txt"
RYZ	= "countries/Misma.txt"
LMW	= "countries/Lucius.txt"
LMI	= "countries/Lumi.txt"
ALF	= "countries/Alfhilde.txt"
FRN	= "countries/Furi.txt"
STR	= "countries/Stronny.txt"
ICE	= "countries/Icey.txt"
AME	= "countries/Amelia.txt"
SHI	= "countries/Shiori.txt"
WLD	= "countries/Wilderwood.txt"
RER	= "countries/Rera.txt"
MAR	= "countries/Mana.txt"
CAL	= "countries/Calidori.txt"
LLA	= "countries/Lala.txt"
SAU	= "countries/Saurei.txt"
ETH	= "countries/Elise.txt"
VTX	= "countries/Vortex.txt"
HAN	= "countries/Hanamiya.txt"
NIM	= "countries/Nimue.txt"
CAT	= "countries/Catato.txt"
CLV	= "countries/Cloverfield.txt"
PEN	= "countries/Penumbral.txt"
MAH	= "countries/Mahochii.txt"
ROM	= "countries/Romania.txt"
YOY = "countries/Yoyo.txt"
NYA = "countries/Nyanners.txt"
SNZ = "countries/Sneeziu.txt"
FBK = "countries/Fubuki.txt"
QUT = "countries/Qutie.txt"
NAL = "countries/Nalithea.txt"
SQU = "countries/SquChan.txt"
AZU = "countries/Azumi.txt"
FRK = "countries/Fraiki.txt"
KYU = "countries/Marikyuun.txt"
CIN = "countries/Cinnia.txt"
BIJ = "countries/Bijou.txt"

# North America #
SHY	= "countries/Shylily.txt"
KRO	= "countries/Empironii.txt"
HAK	= "countries/Haruka.txt"
MIO	= "countries/Mio.txt"
GUH	= "countries/Underworld.txt"
INA	= "countries/Ina.txt"
MOZ	= "countries/Mozzumite Republic.txt"
DOK	= "countries/Doki.txt"
NER	= "countries/Nerissa.txt"
FSA	= "countries/Freesia.txt"
ZAO	= "countries/Zaotome.txt"
YAR	= "countries/Marine.txt"
IRN	= "countries/Ironmouse.txt"
FOX	= "countries/Foxhound.txt"
LUL	= "countries/Lulu.txt"
CAM	= "countries/Camizole.txt"
RIH	= "countries/RIHSURI.txt"
SER	= "countries/Sera.txt"

# South America #
DOD	= "countries/Dodoland.txt"
YAH	= "countries/Yashiro.txt"
RED	= "countries/Claude.txt"
ELY	= "countries/Elyssia.txt"
CYU	= "countries/CyYu.txt"
REI	= "countries/Reimu.txt"
STA	= "countries/Star.txt"
ZTA	= "countries/Ztaellar.txt"
THZ	= "countries/Thaazminchan.txt"
MAG	= "countries/Magochi.txt"

# Asia

# Africa #
BOT	= "countries/Botan.txt"
AIV	= "countries/Aivori.txt"
DAE	= "countries/Miridae.txt"
INO	= "countries/Inowi.txt"
MEW	= "countries/Meowly.txt"
FUW	= "countries/Fuwawa.txt"
MOC	= "countries/Mococo.txt"

# Middle-East #
HOO	= "countries/Hooman Civilization.txt"

# Oceania #
AST	= "countries/Australia.txt"
HAA	= "countries/Haachama Order.txt"
MOL	= "countries/Mollymishy.txt"

# Antarctica #